#########
#C#E##E.#
#.#F##.##
#.#A##A##
#.#S##A##
#..S...##
#########