###A#####
#C#E##EF#
#.#F##.##
#.#A##A##
#.#.##A##
#....F.##
########A