##############
#C..#....E...#
#.#.##F#.#.###
#.#S.#.#.#..E#
#.#S.#F#.###.#
#.#..A..#.A#.#
#..#A##A##.#.#
####A##A##.#.#
##############
